  AlbedoMod = "albedo",
  AloyMod = "aloy",
  AmberMod = "amber",
  AmberCNMod = "ambercn",
  AyakaMod = "ayaka",
  AyatoMod = "ayato",
  BarbaraMod = "barbara",
  BarbaraSummertimeMod = "barbarasummertime",
  BeidouMod = "beidou",
  BennettMod = "bennett",
  CandaceMod = "candace",
  ChildeMod = "childe",
  ChongyunMod = "chongyun",
  ColleiMod = "collei",
  CynoMod = "cyno",
  DilucMod = "diluc",
  DilucFlammeMod = "dilucflamme",
  DionaMod = "diona",
  DoriMod = "dori",
  EulaMod = "eula",
  FischlMod = "fischl",
  FischlHighnessMod = "fischlhighness",
  GanyuMod = "ganyu",
  GorouMod = "gorou",
  HeizouMod = "heizou",
  HuTaoMod = "hutao",
  IttoMod = "itto",
  JeanMod = "jean",
  JeanCNMod = "jeancn",
  JeanSeaMod = "jeansea",
  KaeyaMod = "kaeya",
  KazuhaMod = "kazuha",
  KeqingMod = "keqing",
  KeqingOpulentMod = "keqingopulent",
  KleeMod = "klee",
  KokomiMod = "kokomi",
  KujouSaraMod = "kujousara",
  LaylaMod = "layla",
  LisaMod = "lisa",
  MonaMod = "mona",
  MonaCNMod = "monacn",
  NahidaMod = "nahida",
  NilouMod = "nilou",
  NingguangMod = "ningguang",
  NingguangOrchidMod = "ningguangorchid",
  NoelleMod = "noelle",
  QiqiMod = "qiqi",
  RaidenShogunMod = "raidenshogun",
  RazorMod = "razor",
  RosariaMod = "rosaria",
  RosariaCNMod = "rosariacn",
  SayuMod = "sayu",
  ShenheMod = "shenhe",
  ShinobuMod = "shinobu",
  SucroseMod = "sucrose",
  ThomaMod = "thoma",
  TighnariMod = "tighnari",
  TravelerBoyMod = "travelerboy",
  TravelerGirlMod = "travelergirl",
  VentiMod = "venti",
  XianglingMod = "xiangling",
  XiaoMod = "xiao",
  XingqiuMod = "xingqiu",
  XinyanMod = "xinyan",
  YaeMod = "yae",
  YanfeiMod = "yanfei",
  YelanMod = "yelan",
  YoimiyaMod = "yoimiya",
  YunJinMod = "yunjin",
  ZhongliMod = "zhongli",
