  DullBladeMod = "dullblade",
  SilverSwordMod = "silversword",
  CoolSteelMod = "coolsteel",
  DarkIronSwordMod = "darkironsword",
  FilletBladeMod = "filletblade",
  HarbingerOfDawnMod = "harbingerofdawn",
  SkyriderSwordMod = "skyridersword",
  TravelersHandySwordMod = "travelershandysword",
  AlleyFlashMod = "alleyflash",
  AmenomaKageuchiMod = "amenomakageuchi",
  BlackcliffLongswordMod = "blackclifflongsword",
  BlackSwordMod = "blacksword",
  CinnabarSpindleMod = "cinnabarspindle",
  FavoniusSwordMod = "favoniussword",
  FesteringDesireMod = "festeringdesire",
  FluteMod = "flute",
  IronStingMod = "ironsting",
  KagotsurubeIsshinMod = "kagotsurubeisshin",
  LionsRoarMod = "lionsroar",
  PrototypeRancourMod = "prototyperancour",
  RoyalLongswordMod = "royallongsword",
  SacrificialSwordMod = "sacrificialsword",
  SwordOfDescensionMod = "swordofdescension",
  AquilaFavoniaMod = "aquilafavonia",
  FreedomSwornMod = "freedomsworn",
  HaranGeppakuMod = "harangeppaku",
  JadeCutterMod = "jadecutter",
  MistsplitterMod = "mistsplitter",
  SkywardBladeMod = "skywardblade",
  SummitShaperMod = "summitshaper",
  AetherSwordMod = "aethersword",
  AlhaithamswordMod = "alhaithamsword",
  LumineSwordMod = "luminesword",
  RaidenEiSwordMod = "raideneisword",
